0000000000000000000000000
0211111111110111111111110
0100010000010100000100010
0100010000010100000100010
0100010000010100000100010
0111111111111111111111110
0100010100000000010100010
0111110111110111110111110
0000010000010100000100000
nnnn01011111111111010nnnn
0000010100001000010100000
1111111102222222011111111
0000010100001000010100000
nnnn01011111111111010nnnn
0000010000010100000100000
0111110111110111110111110
0100010100000000010100010
0111111111111111111111110
0100010000010100000100010
0100010000010100000100010
0100010000010100000100010
0111111111110111111111110
0000000000000000000000000
