1111111111111111111111111
1111111111111111111111111
1111111111111111111111111
2222222222222222222222222
1111111111111111111111111
2222222222222222222222222
1111111111111111111111111
1222111121111222212121111
1212111222111211112211111
1212112212211222212221111
1212122111221211112121111
1222121111121222212221111
1111111111111111111111111
1222212112121112122221111
1211212112121112121111111
1212212222121212122221111
1211112112122122121111111
1222212222121112122221111
1111111111111111111111111
2222222222222222222222222
1111111111111111111111111
2222222222222222222222222
1111111111111111111111111
